ltrharvest
index = "undefined"     # specify the name of the enhanced suffix array index (mandatory) default: undefined
range = "0 0"           # specify range in the input sequence(s) in which LTR pairs are searched default: 0 0
seed = "30"             # specify minimum seed length for exact repeats default: 30
minlenltr = "100"       # specify minimum length for each LTR default: 100
maxlenltr = "1000"      # specify maximum length for each LTR default: 1000
mindistltr = "1000"     # specify minimum distance of LTR startpositions default: 1000
maxdistltr = "15000"    # specify maximum distance of LTR startpositions default: 15000
similar = "85.00"       # specify similaritythreshold in range [1..100%] default: 85.00
mintsd = "4"            # specify minimum length for each TSD default: 4
maxtsd = "20"           # specify maximum length for each TSD default: 20
motif = "undefined"     # specify 2 nucleotides startmotif + 2 nucleotides endmotif: **** default: undefined
motifmis = "4"          # specify maximum number of mismatches in motif [0,3] default: 4
vic = "60"              # specify the number of nucleotides (to the left and to the right) that will be searched for TSDs and/or motifs around 5' and 3' boundary of predicted LTR retrotransposons default: 60
overlaps = "best"       # specify no|best|all default: best
xdrop = "5"             # specify xdropbelowscore for extension-alignment default: 5
mat = "2"               # specify matchscore for extension-alignment default: 2
mis = "-2"              # specify mismatchscore for extension-alignment default: -2
ins = "-3"              # specify insertionscore for extension-alignment default: -3
del = "-3"              # specify deletionscore for extension-alignment default: -3
v = "no"                # verbose mode default: no
tabout = "yes"          # show 'old' tabular output instead of GFF3 on stdout default: yes
seqids = "no"           # use sequence descriptions instead of sequence numbers in GFF3 output default: no
md5 = "no"              # add MD5 hashes to seqids in GFF3 output default: no
longoutput = "no"       # additional motif/TSD output default: no
out = "undefined"       # specify FASTA outputfilename default: undefined
outinner = "undefined"  # specify FASTA outputfilename for inner regions default: undefined
gff3 = "undefined"      # specify GFF3 outputfilename default: undefined
help = "NO_ARGS"        # display help for basic options and exit
help+ = "NO_ARGS"       # display help for all options and exit
version = "NO_ARGS"     # display version information and exit
suffixerator
ssp = "yes"             # output sequence separator positions to file   default: yes
des = "yes"             # output sequence descriptions to file   default: yes
sds = "yes"             # output sequence description separator positions to file   default: yes
md5 = "yes"             # output MD5 sums to file   default: yes
clipdesc = "no"         # clip descriptions after first whitespace   default: no
sat = "undefined"       # specify kind of sequence representation   by one of the keywords direct, bytecompress, eqlen, bit, uchar,   ushort, uint32   default: undefined
dna = "no"              # input is DNA sequence   default: no
protein = "no"          # input is protein sequence   default: no
indexname = "undefined" # specify name for index to be generated   default: undefined
db = "NO_ARGS"          # specify database files
smap = "undefined"      # specify file containing a symbol mapping   default: undefined
lossless = "no"         # allow lossless original sequence retrieval   default: no
mirrored = "no"         # virtually append the reverse complement of each sequence   default: no
pl = "0"                # specify prefix length for bucket sort   recommendation: use without argument;   then a reasonable prefix length is automatically determined.   default: 0
dc = "0"                # specify difference cover value   default: 0
spmopt = "0"            # optimize esa-construction for suffix-prefix matching   default: 0
memlimit = "undefined"  # specify maximal amount of memory to be used during index   construction (in bytes, the keywords 'MB' and 'GB' are allowed)   default: undefined
kys = "nosort"          # output/sort according to keys of the form |key| in fasta header   default: nosort
dir = "fwd"             # specify reading direction (fwd, cpl, rev, rcl)   default: fwd
suf = "no"              # output suffix array (suftab) to file   default: no
lcp = "no"              # output lcp table (lcptab) to file   default: no
bwt = "no"              # output Burrows-Wheeler Transformation (bwttab) to file   default: no
bck = "no"              # output bucket table to file   default: no
v = "no"                # be verbose   default: no
showprogress = "no"     # show a progress bar   default: no
ii = "undefined"        # specify existing encoded sequence   default: undefined
help = "NO_ARGS"        # display help for basic options and exit
help+ = "NO_ARGS"       # display help for all options and exit
version = "NO_ARGS"     # display version information and exit
